6,8,64,64,4,8
0,0,0,0,0,0
3,2,2,2,2,0
0,2,2,2,2,0
0,2,2,2,2,0
0,2,2,2,2,5
0,5,2,2,2,0
0,0,0,0,4,0
0,0,0,0,0,0
,,,,,
0,0,0,0,0,0
45,32,32,32,39,0
0,34,0,0,33,0
0,34,0,0,33,0
0,41,35,35,35,43
0,45,37,37,39,0
0,0,0,0,44,0
0,0,0,0,0,0
,,,,,
0,0,0,0,0,0
0,0,0,0,0,0
0,0,0,0,0,0
0,0,0,16,0,0
0,0,8,0,0,0
0,0,0,0,0,0
0,0,0,0,0,0
0,0,0,0,0,0
,,,,,
0,0,0,0,0,0
0,0,0,0,0,0
0,0,0,0,0,0
0,51,51,51,49,0
0,48,50,52,50,0
0,0,0,0,0,0
0,0,0,0,0,0
0,0,0,0,0,0
